################
S             ##
#      #       #
#      #       #
#      #       #
#      #      E#
# ######       #
#      #    1@ #
################

1@
