########################################
S    #                                 #
#    #  %  ############  #######       #
#    #     #             #  !  #       #
#    #######2##########  #     #####3###
#                     #  #     #       #
#        #            #$ #     4       #
#        #            ##################
#        #        *       1            #
#####################################E##

1!
2*
3$
4%